Test
An Interactive Fiction by Kristen
Release 1 / Serial number 221218 / Inform 7 v10.1.2 / D

Hallway
You are on the ground floor of the mall, exploring. You see the food court in front of you to the North and some stores around you.

You can see Auntie Anne's door here.

>examine hallway
You can't see any such thing.

>turn east
You must name something more substantial.

There are 30 minutes to escape!

>go east
Sears
There are 30 minutes to escape!

>go west
Hallway
You are on the ground floor of the mall, exploring. You see the food court in front of you to the North and some stores around you.

You can see Auntie Anne's door here.

There are 30 minutes to escape!

>go south
Justice
You've never seen an abandoned store with so many clothes! Justice has remained pristine despite years of going untouched. Maybe it's all the sparkles? Justice is next to Brooks Brothers.

You can see a clothes rack (in which is a jacket (on which is a jacket pocket (empty))) here.

There are 30 minutes to escape!

* * *

Test
An Interactive Fiction by Kristen
Release 1 / Serial number 221218 / Inform 7 v10.1.2 / D

Hallway
You are on the ground floor of the mall, exploring. You see the food court in front of you to the North and some stores around you.

You can see Auntie Anne's door here.

>go north
(first opening Auntie Anne's door)
It seems to be locked.

>go west
Forever 21

* * *

Test
An Interactive Fiction by Kristen
Release 1 / Serial number 221218 / Inform 7 v10.1.2 / D

Hallway
You are on the ground floor of the mall, exploring. You see the food court in front of you to the North and some stores around you.

You can see Auntie Anne's door here.

>go south
Justice
You've never seen an abandoned store with so many clothes! Justice has remained pristine despite years of going untouched. Maybe it's all the sparkles? Justice is next to Brooks Brothers.

You can see a clothes rack (in which is a jacket) here.

There are 30 minutes to escape!

>examine clothes rack
In the clothes rack is a jacket.

There are 30 minutes to escape!

* * *

Test
An Interactive Fiction by Kristen
Release 1 / Serial number 221218 / Inform 7 v10.1.2 / D

Hallway
You are on the ground floor of the mall, exploring. You see the food court in front of you to the North and some stores around you.

You can see Auntie Anne's door here.

>go to Auntie Anne's
You can't see any such thing.

>look around
You can't see any such thing.

>open auntie anne's door
It seems to be locked.

There are 30 minutes to escape!

* * *

Test
An Interactive Fiction by Kristen
Release 1 / Serial number 221218 / Inform 7 v10.1.2 / D

Hallway
You are on the ground floor of the mall, exploring. You see the food court in front of you to the North and some stores around you.

You can see Auntie Anne's door here.

>look around
You can't see any such thing.

>look
Hallway
You are on the ground floor of the mall, exploring. You see the food court in front of you to the North and some stores around you.

You can see Auntie Anne's door here.

>Go north
(first opening Auntie Anne's door)
It seems to be locked.

>Go south
Justice
You've never seen an abandoned store with so many clothes! Justice has remained pristine despite years of going untouched. Maybe it's all the sparkles? Justice is next to Brooks Brothers.

You can see a clothes rack (in which is a jacket) here.

>take jacket
(the jacket)
Taken.

>look at jacket
(the jacket)
You see nothing special about the jacket.

>inspect jacket
That's not a verb I recognise.

>jacket pocket
That's not a verb I recognise.

>open jacket pocket
That's already open.

>look at jacket pocket
In the jacket pocket is a receipt.